8 8
########
#...#..#
#......#
####p..#
#......#
#....#.#
#....#.#
########