12 24
############
#p..#..#...#
#...#....###
#.###..#.###
#......#...#
#########..#
#.....##...#
#.######.###
#.##.......#
#.##.#####.#
#....#..#..#
######..#..#
###.....#..#
#...#...#..#
#.###......#
#...###..###
###.#......#
##########.#
#.....##...#
#..##..##..#
#...##..##.#
#....##..#.#
#.....#....#
############